%%%%%%%%%%%%%%%%%%%%%
%.      .           %
%     %%%%      %% R% 
%    %% .%%    .%%  %
%    %    %         %
%   %%    %%    %%  %
%   B     .%    %%  % 
%  %%%%%%% %%   %%  %  
%  %            %%  %  
% %%        %%  %%  %  
% %         .%  %%  % 
%.                  %
%%%%%%%%%%%%%%%%%%%%%
