%%%%%
%.B.%
%   %
%   %
%  .%
%.  %
%   %
%   %
%.R.%
%%%%%
